*S**********
*          *
* ******** *
*    *   * *
*** ** * * *
*      * * *
********G***
